00000000000000000000
00000000000000000000
00000000000000000000
00000000000000000000
00000000000000000000
00000001111110000000
00000011111100000000
00000001111000000000
00000000000000000000
00000000000000000000
00000000000000000000
00000000000000000000
00000000000000000000
00000000000000000000
00000000000000000000