000000000000000000000000000000000000000000000000000000000000
000000000000000000000000000000000000000000000000000000000000
000000000000000000000000000000000000000000000000000000000000
000000000000000000000000000000000000000000000000000000000000
000000000000000000000000000222000000000000000000000000000000
000000000000000000000000002222000000000000000000000000000000
000000000000000000000000002220000000000000000000000000000000
000000000000000000000000022220000000000000000000000000000000
000000000000000000000000022220000000000000000000000000000000
000000000000000000000000022220000000000000000000000000000000
000000000000000000000000022200000000000000000000000000000000
000000000000000000000000222200000000000000000000000000000000
000000000000000000000000222000000000000000000000000000000000
000000000000000000000000222000000000000000000000000000000000
000000000000000000000002220000000000000000000000000000000000
000000000000000000000222220000000000000000000000000000000000
000000000000000000222222220000000000000000000000000000000000
000000000000000022222221222000000000000000000000000000000000
000000000000000022221111222200000000000000000000000000000000
000000000000000222211111112220000000000000000000000000000000
000000000000000222111111111220000000000000000000000000000000
000000000000000221111111111222200000000000000000000000000000
000000000000000222111111111122220000000000000000000000000000
000000000000000222111111111111222000000000000000000000000000
000000000000000222111111111111222200000000000000000000000000
000000000000000222211111111111222222000000000000000000000000
000000000000000022211111111112222222222222220000000000000000
000000000000000002221111111112200222222222222220000000000000
000000000000000000222111111122200002222222222222222000000000
000000000000000000022221111222000000000022222222222200000000
000000000000000000002222112220000000000000022222222000000000
000000000000000000000222222200000000000000000000000000000000
000000000000000000000002222000000000000000000000000000000000
000000000000000000000000222000000000000000000000000000000000
000000000000000000000000222000000000000000000000000000000000
000000000000000000000000222000000000000000000000000000000000
000000000000000000000000222000000000000000000000000000000000
000000000000000000000000222000000000000000000000000000000000
000000000000000000000000222000000000000000000000000000000000
000000000000000000000000222000000000000000000000000000000000
000000000000000000000000222000000000000000000000000000000000
000000000000000000000000222000000000000000000000000000000000
000000000000000000000000222000000000000000000000000000000000
000000000000000000000000222000000000000000000000000000000000
000000000000000000000000022000000000000000000000000000000000
000000000000000000000000022200000000000000000000000000000000
000000000000000000000000022200000000000000000000000000000000
000000000000000000000000002220000000000000000000000000000000
000000000000000000000000002220000000000000000000000000000000
000000000000000000000000002220000000000000000000000000000000
000000000000000000000000000220000000000000000000000000000000
000000000000000000000000000220000000000000000000000000000000
000000000000000000000000000000000000000000000000000000000000
000000000000000000000000000000000000000000000000000000000000
000000000000000000000000000000000000000000000000000000000000
000000000000000000000000000000000000000000000000000000000000
000000000000000000000000000000000000000000000000000000000000
000000000000000000000000000000000000000000000000000000000000
000000000000000000000000000000000000000000000000000000000000
000000000000000000000000000000000000000000000000000000000000
