111111111111111111111111111111111111111111111111111111111111
111111111111111111111111111111111111111111111111111111111111
111111111111111111111111111111111111111111111111111111111111
111111111111111111111111111111111111111111111111111111111111
111111111111111111111111111111111111111111111111111111111111
111111111111111111111111111111111111111111111111111111111111
444400000011111111111111111111110000011111111111111100004444
444000000000001111111111110000000000000000000000000000004444
444220000000000000000000000000000000000000000222222222222444
444222222222200000000000000000002222222222222222222222222244
444022222222222222222222222222222222222222222222000000000044
444000022222222222222222222222222222200000000000000000000044
444444000002222222222222222220000000000000000000000044444444
444444400000000000000000002200000000000000000004444444444444
444444440044444444444444002200000000000000000444444444444444
440000000044444444444444002200000000000000000444444444444044
442222220004444444444440002200000003333330000444444000000044
442222222000000000000000002200000003222230000000000000000044
440002222200000000002222222222222223222230000000000000000044
440000222200000022222222222222222222222230000000000000000044
440000022200022222222220002200000003333330000000004444444444
440000022222222222220000002200000000000000444444444444444444
440000002222222200000000002200000000000444444444444444444444
440000000222200000000000002200000000000444444444444444400004
440000000000000000000000002200000000000444440000000000000004
440000000000000000004400002220000000000044400000000000000004
444000000000000000044400002222000000000000000000000000000004
444440000000000044444400002222200000000000000000000000000004
444440000000004444444000000222222000000000333333000000000004
444444400000444444440003333022222200000000322223000000000004
444444400044444444000003222222222220000000322223000000000004
444444444444444400000003222222222222222222222223000000000004
444444444444440000000003223000002222222222222223000000000004
444444444440000000000003223000000022222000322223000000000004
444444444000000000000003333000000000222000333333000000000004
444444440000000000000000000000000000222000000000000000000004
444444440000000000000000000000000000022200000000000000000004
444444440000000000000000000000000000002200000000000000000004
444444440000000000004444444444000000002200000000000000000004
444444440000000004444444444444440000002200000000000000000004
444444440000000444444444444444400000002220000000002222222004
444444444000000444444444444440000000002220000002222222220444
444444444000000044444444400000000000022222222222222220004444
444444444000000000000000000000000000022222222222222000044411
444444444000000000000000000000000002222222222200000000041111
444444444000000000000000000000222222220000000000000000011111
444444444400000000000000002222222222200000000000000001111111
444444444400222222222222222222222220000000000000000011111111
444444444400222222222222222222000000000000000001111111111111
444444444440222222222222200000000000000000011111111111111111
444444444440000000000000000000000000111111111111111111111111
444444444444000000000000000000111111111111111111111111111111
444444444444111111111111111111111111111111111111111111111111
444444444444411111111111111111111111111111111111111111111111
444444444444441111111111111111111111111111111111111111111111
444444444444441111111111111111111111111111111111111111111111
444444444444444111111111111111111111111111111111111111111111
444444444444444111111111111111111111111111111111111111111111
444444444444444411111111111111111111111111111111111111111111
444444444444444411111111111111111111111111111111111111111111
